##############################
#             #              #
#             #              #
#########     #      #       #
#             #      #       #
#             #      #       #
#             #      #       #
#     #########      #       #
#                    #       #
#                    #       #
######################       #
#                            #
#                            #
#                            #
#       ######################
#                #           #
#                #           #
#########        #           #
#                #           #
#                #           #
#                #           #
#      ###########           #
#      #                     #
#      #                     #
#      #                     #
#      #                     #
#      ##############        #
#                            #
#                            #
##############################
