
     #   ### ###  #   ## ## 
   ###  # ### ####      # ##
   #         ##  ##  #   ### 
 # #     ##   ##  #      ## 
  #     ## #  #    #   ##  #
 # # #    #####   #   #  #  
  ##  #      ## #    # # # #
#   ## #   ##      # ## #  #
########       # ##  # #   # 
# #  ## ## #         # #    
# #   ###     #### ### #    
# #   ### #  # # #    #  ## 
 #         # # # # ### # # #
#####      #### #########   
   #  #     #   #####    # 
  ### # #   ###  #   ### ###
#### # #    # ## #   # #####
      #          #  ##  #  # 
####       #    ##  #  ## ##
  #  #    ## ### #    #   # 
  # #  # ##    ## ####    ##
#   # ##  ## # ##   ##  #  #
 #     ### #  # # ## #    ##
## # ##   ##       ## #### # 
## ##  ###  #   #  #  #  ## 
 ### # ###     # # # #   ###
## ##       ### ## #    ## #
#    ## ## # ## # # #  # #  