

     ##########################################################################
     #                                                                        #
     #                                                                        #
     #    ################################################################    #
     #    #                                                              #    #
     #    #                                                              #    #
     #    #    #####################################################     #    #
     #    #    #                                                   #     #    #
     #    #    #                                                   #     #    #
     #    #    #    ###########################################    #     #    #
     #    #    #    #                                         #    #     #    #
     #    #    #    #    #################################    #    #     #    #
     #    #    #    #    ##       ##          ##        ##    #    #     #    #
     #    #    #    #    ##       ##          ##        ##    #    #     #    #
     #    #    #    #    #################################    #    #     #    #
     #    #    #    #                                         #    #     #    #
     #    #    #    ###########################################    #     #    #
     #    #    #                                                   #     #    #
     #    #    #                                                   #     #    #
     #    #    #####################################################     #    #
     #    #                                                              #    #
     #    #                                                              #    #
     #    ################################################################    #
     #                                                                        #
     #                                                                        #
     ##########################################################################
